R 1280 840

NO ./textures/metal.xpm
SO ./textures/brick.xpm
WE ./textures/wood.xpm
EA ./textures/wall.xpm
S ./textures/wall.xpm

F 255,255,0
C 255,0,0

1111111111
1000000001
1010N00001
1000011111
100001
111111