R 1280 840

NO ./textures/me tal.xpm
SO ./textures/brick.xpm
WE ./textures/wood.xpm
EA ./textures/wall.xpm
S ./textures/wall.xpm

F 255,255,0
C 255,0,0

1111
1  1
1 N1
1111